,Name,Symbol,result,ratio_title,ratio_ticker,ratio_summary,ratio_total
142,Air Products and Chemicals Inc. Common Stock,APD,APD,94,0,600,694
86,Intuit Inc. Common Stock,INTU,INTU,100,0,100,200
593,Booz Allen Hamilton Holding Corporation Common Stock,BAH,BAH,100,0,1500,1600
716,CarMax Inc,KMX,KMX,100,0,500,600
5298,MFS Intermediate High Income Fund Common Stock,CIF,CIF,100,0,6000,6100
3829,Landsea Homes Corporation Common Stock,LSEA,LSEA,100,0,900,1000
671,Axon Enterprise Inc. Common Stock,AXON,AXON,100,0,2500,2600
2577,Nextdoor Holdings Inc. Class A Common Stock,KIND,KIND,100,0,100,200
4863,Clough Global Dividend and Income Fund Common Shares of beneficial interest,GLV,SPGI,0,0,9600,9600
1706,Braze Inc. Class A Common Stock,BRZE,BRZE,100,89,500,689
1314,ServisFirst Bancshares Inc. Common Stock,SFBS,SFBS,100,0,700,800
3883,Nuveen Ohio Quality Municipal Income Fund Common Stock,NUO,NUO,100,0,14100,14200
4781,Calamos Global Total Return Fund Common Stock,CGO,CGO,100,0,5000,5100
2929,Health Catalyst Inc Common Stock,HCAT,HCAT,100,0,1100,1200
588,Interpublic Group of Companies Inc. (The) Common Stock,IPG,IPG,100,0,3300,3400
1745,HighPeak Energy Inc. Common Stock,HPK,HPK,100,0,700,800
1830,Air Transport Services Group Inc,ATSG,ATSG,100,0,2600,2700
2870,Cambium Networks Corporation Ordinary Shares,CMBM,CMBM,100,0,900,1000
1272,Foot Locker Inc.,FL,FL,100,0,2300,2400
927,Huntsman Corporation Common Stock,HUN,HUN,100,0,200,300
2222,Sabine Royalty Trust Common Stock,SBR,SBR,100,0,1500,1600
37,Wells Fargo & Company Common Stock,WFC,EAD,0,0,1300,1300
3442,Vivakor Inc. Common Stock,VIVK,VIVK,100,0,100,200
4877,Motorsport Games Inc. Class A Common Stock,MSGM,MSGM,100,0,1300,1400
3032,Carriage Services Inc. Common Stock,CSV,CSV,100,0,700,800
3583,Trean Insurance Group Inc. Common Stock,TIG,TIG,100,0,1500,1600
5385,SAB Biotherapeutics Inc. Common Stock,SABS,SABS,100,0,300,400
1175,Ryan Specialty Holdings Inc. Class A Common Stock,RYAN,RYAN,100,0,300,400
627,Packaging Corporation of America Common Stock,PKG,PKG,100,0,1600,1700
2997,Seneca Foods Corp. Class A Common Stock,SENEA,SENEA,100,0,500,600
6275,Inspirato Incorporated Class A Common Stock,ISPO,ISPO,100,0,100,200
2619,Univest Financial Corporation Common Stock,UVSP,UVSP,100,0,1500,1600
5107,Taylor Devices Inc. Common Stock,TAYD,TAYD,100,0,300,400
5850,Benitec Biopharma Inc. Common Stock,BNTC,BNTC,100,0,300,400
2798,NerdWallet Inc. Class A Common Stock,NRDS,NRDS,100,0,200,300
2355,Moneygram International Inc. Common Stock,MGI,MGI,100,0,900,1000
704,Crown Holdings Inc.,CCK,CCK,100,0,200,300
3660,Tristar Acquisition I Corp. Class A Ordinary Shares,TRIS,TRIS,100,0,600,700
1266,Enact Holdings Inc. Common Stock,ACT,ACT,100,0,400,500
5995,Meta Data Limited ADS,AIU,AIU,0,0,1500,1500
3634,Aurora Cannabis Inc. Common Shares,ACB,ACB,100,0,1100,1200
1722,Novagold Resources Inc.,NG,NG,100,0,1300,1400
2839,Midland States Bancorp Inc. Common Stock,MSBI,MSBI,100,0,1200,1300
3193,Nuveen Pennsylvania Quality Municipal Income Fund Common Stock,NQP,NQP,100,0,13500,13600
5117,TAT Technologies Ltd. Ordinary Shares,TATT,TATT,100,0,1100,1200
5470,MMTec Inc. Common Shares,MTC,MTC,100,0,100,200
3438,Evolv Technologies Holdings Inc. Class A Common Stock,EVLV,EVLV,100,0,900,1000
20,Coca-Cola Company (The) Common Stock,KO,KO,94,0,300,394
2193,Nabors Industries Ltd.,NBR,NBR,100,0,700,800
2567,Bain Capital Specialty Finance Inc. Common Stock,BCSF,BCSF,100,0,1000,1100
815,Rexford Industrial Realty Inc. Common Stock,REXR,REXR,100,0,300,400
3766,Deep Lake Capital Acquisition Corp. Class A Ordinary Shares,DLCA,DLCA,100,0,1000,1100
2329,U.S. Physical Therapy Inc. Common Stock,USPH,ATIP,89,0,1200,1289
2691,Merchants Bancorp Common Stock,MBIN,MBIN,100,0,700,800
6087,Ryvyl Inc. Common Stock,RVYL,RVYL,100,89,0,189
5832,Nova Lifestyle Inc. Common Stock,NVFY,NVFY,100,0,700,800
4758,Center Coast Brookfield MLP & Energy Infrastructure Fund,CEN,CEN,100,0,6200,6300
6139,Edgio Inc. Common Stock,EGIO,EGIO,100,89,300,489
3851,Black Mountain Acquisition Corp. Class A Common Stock,BMAC,BMAC,100,0,600,700
6102,TenX Keane Acquisition Ordinary Share,TENK,TENK,100,0,600,700
1225,Super Micro Computer Inc. Common Stock,SMCI,SMCI,100,0,1500,1600
2954,DXP Enterprises Inc. Common Stock,DXPE,DXPE,100,86,100,286
4611,Everspin Technologies Inc. Common Stock,MRAM,MRAM,100,0,700,800
5368,Acasti Pharma Inc. Class A Common Stock,ACST,ACST,100,0,300,400
5893,Yotta Acquisition Corporation Common Stock,YOTA,YOTA,100,0,900,1000
2763,BJ's Restaurants Inc. Common Stock,BJRI,BJRI,100,0,300,400
3008,MidWestOne Financial Gp Common Stock,MOFG,MOFG,94,0,1200,1294
3169,Invitae Corporation Common Stock,NVTA,NVTA,100,0,300,400
768,BJ's Wholesale Club Holdings Inc. Common Stock,BJ,BJ,100,0,2400,2500
6056,V2X Inc. Common Stock,VVX,VVX,100,0,200,300
5613,Sientra Inc. Common Stock,SIEN,SIEN,100,0,500,600
4329,Whole Earth Brands Inc. Class A Common Stock,FREE,FREE,100,0,1200,1300
1293,Kirby Corporation Common Stock,KEX,KEX,100,0,400,500
5050,L.S. Starrett Company (The) Common Stock,SCX,SCX,0,0,800,800
1228,Alkermes plc Ordinary Shares,ALKS,ALKS,100,0,200,300
6019,Permian Resources Corporation Class A Common Stock,PR,PR,100,0,1300,1400
2732,IDEAYA Biosciences Inc. Common Stock,IDYA,IDYA,100,0,700,800
739,Reinsurance Group of America Incorporated Common Stock,RGA,RGA,100,0,2200,2300
5147,Sensei Biotherapeutics Inc. Common Stock,SNSE,SNSE,100,0,700,800
4330,Exicure Inc. Common Stock,XCUR,XCUR,100,0,200,300
5275,Aquestive Therapeutics Inc. Common Stock,AQST,AQST,100,0,700,800
2031,Gulfport Energy Corporation Common Shares,GPOR,GPOR,100,0,300,400
6018,Lipocine Inc. Common Stock,LPCN,LPCN,100,0,100,200
651,WPP plc American Depositary Shares,WPP,PAAS,0,0,800,800
999,Axalta Coating Systems Ltd. Common Shares,AXTA,AXTA,100,0,3600,3700
3541,Live Oak Mobility Acquisition Corp. Class A Common Stock,LOKM,LOKM,100,0,1000,1100
146,Fiserv Inc. Common Stock,FISV,FISV,100,0,100,200
2915,Vishay Precision Group Inc. Common Stock,VPG,VPG,100,0,1800,1900
2385,Zentalis Pharmaceuticals Inc. Common Stock,ZNTL,ZNTL,100,0,200,300
4198,PrimeEnergy Resources Corporation Common Stock,PNRG,PNRG,100,0,900,1000
2192,Sinclair Broadcast Group Inc. Class A Common Stock,SBGI,SBGI,100,0,2400,2500
4839,Acme United Corporation. Common Stock,ACU,ACU,100,0,1500,1600
3336,Gevo Inc. Common Stock,GEVO,GEVO,100,100,500,700
2852,Endeavour Silver Corporation Ordinary Shares (Canada),EXK,EXK,100,0,1300,1400
5925,Genesis Unicorn Capital Corp. Class A Common Stock,GENQ,GENQ,100,0,600,700
4077,BNY Mellon Municipal Bond Infrastructure Fund Inc. Common Stock,DMB,DMB,100,0,9300,9400
3850,Ur Energy Inc Common Shares (Canada),URG,URG,94,0,0,94
959,DigitalBridge Group Inc.,DBRG,DBRG,100,0,500,600
40,Accenture plc Class A Ordinary Shares (Ireland),ACN,ACN,100,0,100,200
2609,BioLife Solutions Inc. Common Stock,BLFS,BLFS,100,0,700,800
